****************************!********
******** **** *          *** * *    *
**    **    * * ***** ** *       ** *
*****    **   * *  * *** ******* ** *
*   **** ** * * **  **        *     *
*  **  *    *** *** ** **** **  *** *
**  **   **  ** * *       * *  **** *
***  *** *** ** * ** * ** * * **    *
*     **  ** ** * ** * ** *** *  ** *
* *** *** ** ** * ** * **     * *** *
* *   *** ** ** *    *  ******* *   *
* * * *** **  * *********     * * ***
* * *     *** *               * * ***
* * * ** ** * *************** * ** **
* * ** ** * *   ***           *    **
*           ***     ** *********** **
**********************@**************
