*************************************
******** **** *          *** * *    *
** !  **    * * ***** **!*       ** *
*****    **   * *  * *** ******* ** *
*   **** ** * * **  **        *     *
*  **  *    *** *** ** **** **  *** *
**  **@  **  ** * *       * *  **** *
***  *** *** ** * ** * ** * * **    *
*     **  ** ** * ** *!** *** *  ** *
* *** *** ** ** * ** * **     * *** *
* *   *** ** ** *    *  ******* *   *
* * * *** **  *@*********     *@* ***
* * *     *** *               * * ***
* * * ** ** * *************** * ** **
* *!** ** * *   ***           *    **
*           ***     ** *********** **
*************************************
