*************************************
******** **** *          *** * *    *
**    **    * * ***** ** *       **!*
*****    **   * *  * *** ********** *
*   **** ** * * **  **        *     *
*  **  *    *** *** ** **** **  *** *
**  **   **  ** * *       * *  **** *
***  *** *** ** * ** * ** * ****    *
*     **  ** ** * ** * ** *** *  ** *
* *** *** ** ** * ** * **     * *** *
* *   *** ** ** *    *  ******* *   *
* * * *** **  *@*********     * * ***
* * *     *** *               * * ***
* * * ** ** * *************** * ** **
* * ** ** * *   ***           *    **
*           ***     ** *********** **
*************************************
